1111111111111
10010000000C1
1001011111001
1P0111E000001
1111111111111
