1111111111111
10010000000C1
1001011111001
1P0111E000001
1001000001001
1001011111001
10000000000C1
100100C000001
1111100111111
10010000000C1
1111111111111
