1111111111111
1001000000C01
1001000000001
1P01110000E01
1000000X00001
1111111111111